NO ./resources/Rocky.xpm
SO ./resources/Water.xpm
WE ./resources/Magma.xpm
EA ./resources/Brick_Wall_Cracked.xpm

F 255,255,255
C ,,,

1111111111111111111111111
1000000000110000000000001
101100000111000000W000001
1001000000000000000000001
1111111011111111111111111
1000000000000000000000001
1000000000000000000000001
1000000000000000000000001
1000000000000000000000001
1111111110110000011100001
1000000000110000011100001
1011000000000000000000001
1001000000000000000000001
1111111111111111111111111
