NO ./resources/north.xpm
SO ./resources/south.xpm
WE ./resources/west.xpm
EA ./resources/east.xpm

F 255,0,255
C 100,50,200

111111111111111
110000000000001
10100N000000001
100100000000001
100010000000001
100001000000001
100000100000001
100000010000001
100000001000001
100000000100001
100000000010001
100001000001001
100000000000101
100000000000011
111111111111111