NO ./resources/north.xpm
SO ./resources/south.xpm
WE ./resources/west.xpm
EA ./resources/east.xpm

F 255,0,255
C 100,50,200
111111111111111
110000000000001
1000E0000000101
100000000000101
111111111111111