NO ./resources/north.xpm
SO ./resources/south.xpm
WE ./resources/west.xpm
EA ./resources/east.xpm

F 255,0,255
C 100,50,200
111111111111111
110010000000001
10E010000000101
100010000000101
111111111111111