NO ./resources/north.xpm
SO ./resources/south.xpm
WE ./resources/west.xpm
EA ./resources/east.xpm

F 255,0,255
C 100,50,200

11111111111111111111111111111111111111
10000000001000000000001000000000000001
10000000001111111111101010111111111101
10000E00000000000000000010111010111101
10000000001110111111111010100000000001
10000000001010100000000010111101111111
11111111111010101111111110100000000001
10000000000010101010000000101111111101
10111111111110100000111111101110000001
10000000000000101110100000001111111111
11111111111111101111101111111111111111
10000000000000001111111111110000011111
10111111111111111111111111110000011111
10000000000000000000000000000000011111
11111111111111111111111111110000011111
11111111111111111111111111111111111111