NO ./resources/Brick_Wall.xpm
SO ./resources/Brick_Wall.xpm
WE ./resources/Brick_Wall.xpm
EA ./resources/Brick_Wall.xpm

F 136,134,130
C 165,162,158

1111111111111111111111111
1000000000110000000000001
1011000001110000000000001
1001000000000000000000001
1111111110110000011100001
1000000000110000000000001    1111111111111
1000000000000000000000001    1000000000001
100000000000000000000000111111000000000001
10000000000000000000000000000000000000W001
100000000000000000000000111111000000000001
1000000000000000000000001    1000000000001
1111111111111111111111111    1111111111111
