NO           ./resources/north.xpm
SO              ./resources/south.xpm
WE   	./resources/west.xpm
EA ./resources/east.xpm

F 255,0,255
C 100,50,200

11111111111111111111111111111111           
100000000000110000000000000000001           
100000000000110000000000000000001           
1000000E000000000000110000110000111111111
11111111111110000000000000001100001100001           
10000000000110000000110000000000000000001           
11101111111110000000110000000000000000001           
11101111111110000000111111111111111111111     1     
1100000000011000000011000000000000001               
1000111100001000000011000111111000001   1           
10001   100000000000001100010000100001111             
100011110000100000001100000000000001111111  11111111
110000011111101000101111111101110001        10000001
11100011   11110001111   11010010001        10000001
11110111   11111011111   10101110001        10000001
11111111   11111111111   11111111111        11111111
111111
