NO ./resources/1_1_.xpm





SO      ./resources/2_1_.xpm
WE ./resources/4_1_.xpm
EA ./resources/3_1_.xpm

F    0,255,0
C    255,,255

11111
10001
10W01
10001
11111